ENERGY = 1
MITOSIS = 2
FORBIDDEN = 3
NORMAL = 4

8
2 4 4 4 1 1 1 1
4 4 4 4 1 2 2 1
3 3 3 4 1 1 1 1
4 4 4 4 1 4 4 4
2 4 4 4 1 4 4 2
4 4 4 4 1 4 4 4
4 4 4 3 3 4 4 4
2 4 4 3 3 4 4 2
